############
#          #
#  P    ####
#          #
####### X  #
#    ##    #
#    ## O  #
#          #
#       X  #
#      #   #
############
