111111111111111
111112222222232
111112111111111
111112111111111
222222111111111
111111111111111
